8,8
XXXXXXXX
___2___X
X______X
X_____LX
X______X
X__U___X
X1_____X
XXXXXXXX
00000000
00000200
00000000
000M0000
00000000
00000100
00000000
00000000