9,8
XXXXXXXXX
X___2X__X
X_______X
X______LX
XX______X
X_____L_X
X_______X
XXXXXXXXX
000000000
000000000
000000000
000000000
000000000
000000100
000000100
000000000